XXXXXXX
XS    X
XXX   X
X   X X
X   X X
X X   X
XXXXXXX